usta	Tennis
federer	Tennis
wimbledon	Tennis
tennis	Tennis
mlb	Baseball
baseball	Baseball
softball	Baseball
txrangers	Baseball
basketball	Basketball
nba	Basketball
soccer	Soccer
fifa	Soccer
euro2016	Soccer
uefa	Soccer
olympic	Olympic
olympics	Olympic
rio2016	Olympic
olympic	Olympic
afl	Football
football	Football
collegefootball	Football
